+--+--+--+--+
|           |
+--+  +  +--+
|     |     |
+  +--+  +  +
|  |     |  |
+  +--+--+  +
|  g  |     |
+--+--+--+--+

