+--+--+--+--+
|        |  |
+  +--+  +  +
|  |     |  |
+  +  +--+--+
|  |        |
+--+--+  +--+
|     g     |
+--+--+--+--+

