+--+--+--+--+--+--+--+
|p        |         g|
+  +--+--+  +--+--+--+
|  |        |        |
+  +  +--+  +  +--+  +
|  |     |  |     |  |
+  +--+  +--+--+  +  +
|                 |  |
+--+--+--+--+--+--+--+
