+--+--+--+--+--+--+
|p          |     |
+  +--+--+--+  +  +
|  |        |  |  |
+  +  +--+  +  +  +
|  |     |        |
+  +--+  +--+  +--+
|           | g   |
+--+--+--+--+--+--+
